accession_id,total_reads,genus,genus_taxid,genus_true_positive,genus_true_negative,genus_false_positive,genus_false_negative,species,species_taxid,species_true_positive,species_true_negative,species_false_positive,species_false_negative
NZ_CP126983.1,37686,Porphyromonas,836,37461,958844,6,225,Porphyromonas gingivalis,837,37397,958844,6,289
NZ_CP027286.1,26067,Clostridium,1485,26067,970443,26,0,Clostridium chauvoei,46867,25962,970469,0,105
NZ_CP008852.1,22555,Pelosinus,365348,22555,973981,0,0,Pelosinus sp. UFO1,484770,22553,973981,0,2
NZ_CP045696.1,9132,Sodaliphilus,2815786,9066,987404,0,66,Sodaliphilus pleomorphus,2606626,9066,987404,0,66
NZ_CP033719.1,40603,Propionibacterium,1743,40597,955930,3,6,Propionibacterium acidifaciens,556499,40597,955933,0,6
NZ_CP017042.1,3905,Selenomonas,970,3905,992631,0,0,Selenomonas sp. oral taxon 920,1884263,3898,992631,0,7
NZ_CP036259.1,12631,Sporomusa,2375,12631,983905,0,0,Sporomusa termitida,2377,12631,983905,0,0
NZ_CP033459.1,26839,Pseudoprevotella,2884814,26833,969697,0,6,Pseudoprevotella muciniphila,2133944,26833,969697,0,6
NZ_CP073804.1,37694,Macrococcoides,3076173,37251,958841,1,443,Macrococcoides canis,1855823,37156,958841,1,538
NZ_CP118095.1,92668,Aerococcus,1375,91448,903864,4,1220,Aerococcus christensenii,87541,91445,903867,1,1223
NZ_CP071986.1,5097,Helicobacter,209,5097,991439,0,0,Helicobacter pylori,210,5097,991439,0,0
NZ_CP012196.1,7806,Campylobacter,194,7806,988730,0,0,Campylobacter gracilis,824,7806,988730,0,0
NZ_CP029033.1,9981,Actinobaculum,76833,9981,986555,0,0,Actinobaculum sp. 313,2495645,9981,986555,0,0
NZ_CP012069.2,39356,Olsenella,133925,39356,957180,0,0,Olsenella sp. oral taxon 807,712411,39355,957180,0,1
NZ_CP019962.1,9309,Eubacterium,1730,9309,987225,2,0,Eubacterium limosum,1736,8770,987227,0,539
NZ_CP039712.1,18621,Vagococcus,2737,18609,977914,1,12,Vagococcus zengguangii,2571750,18569,977915,0,52
NZ_CP020566.1,4518,Veillonella,29465,4515,992018,0,3,Veillonella atypica,39777,4513,992018,0,5
NZ_CP017761.1,42958,Marinilactibacillus,191769,42621,953578,0,337,Marinilactibacillus sp. 15R,1911586,42621,953578,0,337
NZ_CP054018.1,10180,Rothia,32207,10153,986356,0,27,Rothia dentocariosa,2047,10126,986356,0,54
NZ_CP025330.1,12549,Brevibacterium,1696,12209,983986,1,340,Brevibacterium aurantiacum,273384,10273,983987,0,2276
NZ_CP085178.1,4707,Pediococcus,1253,4706,991827,2,1,Pediococcus pentosaceus,1255,4699,991829,0,8
NZ_CP040235.1,14892,Bifidobacterium,1678,14877,981644,0,15,Bifidobacterium longum,216816,14160,981644,0,732
NZ_CP054494.1,30075,Flavobacterium,237,30071,966455,6,4,Flavobacterium columnare,996,29569,966461,0,506
NZ_CP120209.1,36487,Chryseobacterium,59732,36238,960049,0,249,Chryseobacterium indologenes,253,35824,960049,0,663
NZ_AP025575.1,8895,Eggerthella,84111,8880,987639,2,15,Eggerthella lenta,84112,8859,987639,2,36
NZ_CP013476.1,1601,Turicibacter,191303,1594,994926,9,7,Turicibacter sp. H121,1712675,817,994935,0,784
NZ_CP032819.1,5112,Butyricimonas,574697,4549,991419,5,563,Butyricimonas faecalis,2093856,4544,991424,0,568
NZ_CP016839.1,16860,Brochothrix,2755,16856,979676,0,4,Brochothrix thermosphacta,2756,16856,979676,0,4
NZ_CP040004.1,35544,Candidatus Nanosynbacter,2093823,35535,960992,0,9,Candidatus Nanosynbacter featherlites,2572088,35445,960992,0,99
NZ_AP019735.1,15177,Alistipes,239759,14852,981334,25,325,Alistipes communis,2585118,14835,981356,3,342
NZ_CP098491.1,5227,Bacillus,1386,5205,991305,4,22,Bacillus subtilis,1423,901,991308,1,4326
NZ_CP015348.1,3392,Sporosarcina,1569,3391,993142,2,1,Sporosarcina ureae,1571,3381,993144,0,11
NZ_CP072246.1,43172,Phocaeicola,909656,38668,953353,11,4504,Phocaeicola dorei,357276,37174,953360,4,5998
NZ_CP040915.1,17525,Georgenia,154116,17525,979011,0,0,Georgenia yuyongxinii,2589797,17524,979011,0,1
NZ_CP097775.1,30939,Paenibacillus,44249,30939,965595,2,0,Paenibacillus polymyxa,1406,30324,965597,0,615
NZ_CP047630.1,6203,Lactococcus,1357,6169,990331,2,34,Lactococcus raffinolactis,1366,6119,990333,0,84
NZ_CP026548.1,23740,Faecalibacterium,216851,23424,972789,7,316,Faecalibacterium prausnitzii,853,23034,972795,1,706
NZ_CP117966.1,5552,Roseburia,841,5358,990983,1,194,Roseburia hominis,301301,5343,990984,0,209
NZ_CP066811.1,35929,Peptacetobacter,2743582,35830,960607,0,99,Peptacetobacter hiranonis,89152,35830,960607,0,99
NZ_CP050134.2,9852,Corynebacterium,1716,9852,986680,4,0,Corynebacterium matruchotii,43768,9852,986684,0,0
NZ_CP046313.1,8004,Gemella,1378,7985,988532,0,19,Gemella sanguinis,84135,7969,988532,0,35
NZ_CP011861.1,51969,Erysipelothrix,1647,51969,944567,0,0,Erysipelothrix rhusiopathiae,1648,51156,944567,0,813
NZ_CP040348.1,44836,Collinsella,102106,44541,951700,0,295,Collinsella aerofaciens,74426,44541,951700,0,295
NZ_CP017428.1,15429,Staphylococcus,1279,15429,980983,124,0,Staphylococcus simulans,1286,15378,981105,2,51
NZ_CP068103.1,8224,Peptoniphilus,162289,7882,988312,0,342,Peptoniphilus harei,54005,7881,988312,0,343
NZ_CP029197.1,4832,Streptomyces,1883,4818,991695,9,14,Streptomyces venezuelae,54571,4768,991704,0,64
NZ_CP077403.1,24354,Jonesia,43673,24353,972182,0,1,Jonesia denitrificans,43674,24353,972182,0,1
NZ_CP017038.2,1481,Tannerella,195950,1481,995054,1,0,Tannerella serpentiformis,712710,1481,995054,1,0
NZ_CP027228.1,11351,Mogibacterium,86331,11341,985185,0,10,Mogibacterium diversum,114527,11331,985185,0,20
NZ_CP023482.1,5020,Dermabacter,36739,4894,991516,0,126,Dermabacter jinjuensis,1667168,4507,991516,0,513
